0b11111111, 0b11101010, 0b11010101, 0b11000000, 
0b11101010, 0b11100110, 0b11100010, 0b11000000, 
0b11101010, 0b11001010, 0b11000101, 0b11000000, 
0b11111111, 0b11101011, 0b11010111, 0b11000000, 
0b11111101, 0b11101010, 0b11100110, 0b11000000, 
0b11101010, 0b11100100, 0b11010000, 0b11000000, 
0b11000000, 0b11000000, 0b11000000, 0b11000000, 
0b11000000, 0b11000000, 0b11000000, 0b11000000, 
