0b11111111, 0b11101010, 0b11010101, 0b11000000, 
0b11111111, 0b11111010, 0b11110110, 0b11000000, 
0b11101101, 0b11011000, 0b11000100, 0b11000000, 
0b11000000, 0b11000000, 0b11000000, 0b11000000, 
0b11111111, 0b11111101, 0b11111000, 0b11000000, 
0b11111111, 0b11111001, 0b11100100, 0b11000000, 
0b11000000, 0b11000000, 0b11000000, 0b11000000, 
0b11000000, 0b11000000, 0b11000000, 0b11000000, 
