{
	{0,0,1,1,},
	{2,2,2,2,},
	{3,3,3,3,},
	{4,4,4,4,},
	{2,5,2,5,},
	{3,6,3,6,},
	{7,7,2,2,},
	{2,2,7,2,},
	{7,2,7,7,},
	{7,7,7,7,},
	{2,7,2,2,},
	{7,2,2,2,},
	{2,2,7,7,},
	{2,2,8,8,},
	{2,7,7,7,},
	{9,2,9,2,},
	{9,2,10,8,},
	{7,7,2,7,},
	{2,2,2,7,},
	{2,2,8,2,},
	{2,11,2,11,},
	{2,11,8,12,},
	{7,7,7,2,},
	{2,2,2,13,},
	{14,2,14,2,},
	{15,3,15,3,},
};